80 25
 ## #     # #    #               #      #                       ## ###         
  ####   ###### ########   ######        ##### ######### #### #######
   ########## ## #####    ####    #          #####################
    #######################      ##            ### ##  #### ####  ##
     ######### #########         ###            ##  #   ### ##   ##
#      # #####   #######         ###                      #      #
      #   ###       ##                          ####### 
      #    ###                                 ###########     #
            ###   ##                          ##############              #
#             ###                              ##############                #
              ##                               #############
            #####                               ###########       ##
          #########                             ##########      ##
        ############                              #########     ##
      ###############                              #######
     ##############                                 #####           #########
    ############### ##                               ###           ###########
     ###############                                  #           ############
      ############                                                ###   ####
       #########      #                                
#          #####
          
          ########                        ######               #######
        ###################### ###########################  ##############
##############################################################################
